[level]
tileset = dungeon.png
map =   ###############
        #.........,...#
        #.>...,.......#
        #.@...........#
        #....,..,.....#
        #.............#
        #.........,...#
        #.............#
        #.............#
        #.......,.....#
        #....,........#
        #..........,..#
        #...,.........#
        #.............#
        ###############

[#]
name = wall
wall = true
block = true

[.]
name = floor
tile = 0, 3

[,]
name = leafyfloor
tile = 2, 3

[@]
name = player
tile = 0, 3
player = true
sprite = player.png

[>]
name = stairs
tile = 3, 3
connect = auto
level = house.map
connectchar = >
